SENT-END	[]	sil
SENT-START	[]	sil
aroha	[aroha]	a r o h a
awa	[awa]	a w a
enoho	[enoho]	e n o h o
haeremai	[haeremai]	h ae r e m ai
hangi	[hängï]	h aa N ii
hapuu	[hapü]	h a p uu
hau	[hau]	h au
hei	[hei]	h ei
hoe	[hoe]	h oe
hoihoi	[hoihoi]	h oi h oi
hongi	[hongi]	h o N i
hou	[hou]	h ou
hë	[hë]	h ee 
hï	[hï]	h ii 
iwa	[iwa]	i w	a	
iwi	[iwi]	i w i
kainga	[käinga]	k aa i N a
kakiteano	[kakiteanö]	k a k i t e a n oo
kapai	[kapai]	k a p ai
karakia	[karakia]	k a r a k i a
karanga	[karanga]	k a r a N a
kaumaatua	[kaumätua]	k au m aa t u a
kei	[kei]	k ei
kete	[kete]	k e t e
kiaora	[kiaora]	k i a o r a
koha	[koha]	k o h a
korero	[körero]	k oo r e r o
kuia	[kuia]	k u i a
kë	[kë]	k ee 
kï	[kï]	k ii
mao	[mao]	m ao
maori	[mäori] m aa o r i
marae	[marae] m a r ae
matariki	[matariki] m a t a r i k i
matiu	[matiu]	m a t i u
mau	[mau]	m au
maunga	[maunga] m au N a
mihi	[mihi]	m i h i
moana	[moana]	m o a n a
mokopuna	[mokopuna]	m o k o p u n a
moutere	[moutere]	m ou t e r e
mätao	[mätao]	m aa t ao 
mätau	[mätau]	m aa t au 
mätou	[mätou]	m aa t ou 
ono	[ono]	o n o
pae	[pae]	p ae
pai	[pai]	p ai
pao	[pao]	p ao
pau	[pau]	p au
pou	[pou]	p ou
powhiri	[pöwhiri]	p oo f i r i
puku	[puku]	p u k u
pö	[pö]	p oo
rangatiratanga	[rangatiratanga] r a N a t i r a t a N a	
rima	[rima]	r i m a
rua	[rua]	r u a
sil	[sil]	sil
silence	[silence]	sil
tae	[tae]	t ae
tahi	[tahi]	t a h i
tai	[tai]	t ai
tamariki	[tamariki]	t a m a r i k i
tangi	[tangi]	t a N i
taringa	[taringa]	t a r i N a
tauhou	[tauhou]	t au h ou
tekau	[tekau]	t e k au
tena_koe	[tënäkoe]	t ee n aa k oe
tikanga	[tikanga]	t i k a N a
timata	[tïmata]	t ii m a t a
toetoe	[toetoe]	t oe t oe
toi	[toi]	t oi
toru	[toru]	t o r u
turanga	[türanga]	t uu r a N a
täne	[täne]	t aa n e
tënei	[tënei]	t ee n ei
tü	[tü]	t uu
wa	[wä]	w aa
waewae	[waewae]	w ae w ae
wahi	[wähi]	w aa h i
waiata	[waiata]	w ai a t a
wairua	[wairua]	w ai r u a
waka	[waka]	w a k a
waru	[waru]	w a r u
wha	[whä]	f aa
whanau	[whänau]	f aa n au
whare	[whare]	f a r e
whitu	[whitu]	f i t u


